6 8 3 5 3 4
H 1 . . . . A . . 
. . S S . R . . . 
T . . 2 . . . . . 
. . . . . . . . . 
. . . . . . . . . 
. . . . . . . . . 
