6 9 3 5 3 4
H 1 . . . R A . . 
. . S S . . H H . 
T . . 2 . t . H 6 
. H . . t t t . . 
H . 3 . . t . 5 . 
7 . . 4 . . . 8 . 
