6 9 100 20 100 10
H . N N A A A A . 
. 1 S S A R H H . 
T T . . . . . H 6 
. H T . . . . 2 . 
H . . . . . . 5 . 
7 . 3 . 4 H 8 . . 