20 30 3 20 1 10
H H H H H H H H H H H H H H H H H H H H H H H H H H H H H H
H 1 . . S . S . . . . . S . . . S . . . . S . . . S . . 2 H
H . H H . H . H H . H H . H H . H H . H H . H H . H . H . H
H . H . . . A . . S . . . . S . . . . . S . . . A . . H . H
H S . . H . H . H H . H H . H H . H H . H H . H . H . . S H
H . . S . . . . . . T . . . . . . R . . . . . . . . S . . H
H . H . H H . H H . H H . H H . H H . H H . H H . H H . . H
H S . . . . S . . . . . . A . . . . . S . . . . . . . S . H
H . H H . H . H H . H H . H H . H H . H H . H H . H . H . H
H . . S . R . . S . . S . . . T . . S . . . A . . S . . . H
H H . H H . H H . H H . H H . H H . H H . H H . H H . H H H
H . . . S . . . . S . . A . . . . . . S . . . . S . . . . H
H . H . H H . H H . H H . H H . H H . H H . H H . H H . . H
H S . T . . . . . . . . . . S . . . . . . R . . . . . S . H
H . H H . H . H H . H H . H H . H H . H H . H H . H . H . H
H . . . . . S . . A . . S . . . S . . . . S . . T . . . . H
H H . H H . H H . H H . H H . H H . H H . H H . H H . H H H
H . . S . . . . R . . . . . . S . . . . A . . . . . S . . H
H . H . H H . H H . H H . H H . H H . H H . H H . H H . . H
H H H H H H H H H H H H H H H H H H H H H H H H H H H H H H
