6 9 3 5 3 4
H 1 . . . . A . . 
. . S S . R H H . 
T . . 2 . . . H 6 
. H . . . . . . . 
H . 3 . . . . 5 . 
7 . . . 4 H 8 . . 